   ####
####  ##
#@$    ##
#..***  #
# $     #
#####  ##
    ####
