  #####
  #   ###
  # #*  #
 ##.*   #
 # @ # ##
##$#*#  #
#    *  #
#   ##  #
#########
