   #####
####. .###
# $  #   #
#@# .$.$ #
# $ # # ##
###     #
  #######
