 #########
 #       #
 # ##### #
 # #   # #
 # $.#@# #
###$.  # #
#  $.### #
# #$.    #
#    #####
######
