#### #####
#  ###   #
#  $     #
#  #$##$##
## #@    #
 # #$# # ##
 # # . .  #
 #    #   #
 #  #. .###
 ########
