#########
#   #   #
# $   $ #
##$#@#$##
 #. ..  #
 ## .#  #
  ##   ##
   #####
