 #######
 #  #  #
 #     #
## ##  #
#   #.##
#   *  #
### *  #
  #$* ##
  #@ ##
  ####
