######
#    ####
# ## .  #
# ###*# #
# # $@# #
# # * # #
#   *   #
## # ####
 #   #
 #####
