  ####
###.@###
#      #
# *..# #
## #$$ #
 #    ##
 ##$# #
  #   #
  #####
