 #####
 #   #
 # # ##
## *  ##
# $*$  #
#  * #@#
## .  .#
 #######
