  ####
###  ###
#   .  #
#  $ $ #
##.#.#.#
 # $@$ #
 ###  ##
   ####
