  #######
 ##  #  #
 # * *  #
##   #  #
#  *#.@##
#     $#
#####  #
    ####
