######
#    ##
#  *  #
# $*$ #
## * ##
 # * #
 # .@#
 ##.##
  ###
