     ####
 #####  #
 # $    #
## #.##$#
#  # @. #
#  .$ # ##
## ##.#  #
 #    $  #
 #  ######
 ####
