  ########
  #   #  #
  #   $. #
 ###$##  #
 # $.## ##
##  .*   #
#  #$#   #
# .@ #####
##   #
 #####
