  #####
  #   ###
###*# $ #
# $ @ # #
# # ..  #
# . #$###
##$.  #
 #  ###
 ####
