 #####
 #   #
 # #$##
## @  #
# .#$ #
# .  ##
# .#$#
##   #
 #####
