#### ####
#  ###  #
# $ * $ #
#  @.   #
### .$###
  # . #
  #####
