#####
#   ###
#.#$  #
# @$* #
#  $  #
##.#.##
 #   #
 #####
