     ####
 #####  #
 # $ $  #
 #.# #. #
 # $@$ ##
##.# #.##
#  * *  #
#   #   #
#########
