 #####
 #   ###
## #$ @#
# . $  #
#...#$##
# #  $ #
#  #   #
##   ###
 #####
