    ####
#####  #
# $   $#
#  .#. #
## ### ##
 # .#.  #
 #$ @ $ #
 #  #####
 ####
