 #########
 #  ##   #
##  *  # #
# .$#*@  #
#   *   ##
#########
