  #####
  #   #
###*# ##
#    * #
# #  # #
# * .@ #
##  #$##
 ##   #
  #####
