#####
#   ###
#     #
##    #
####$##
#  $ ##
# @   #
###. .#
  #####
