    #####
   ##   ##
  ## .#  #
 ##   @  #
##  * #  #
#  $ #####
# * ##
#  ##
####
