#####
#   ##
# #  ###
#   *$ #
###  #@#
  # *. #
  #  ###
  ####
