   ####
####  #
# $   #
#  .# ##
## #.  #
# @  $ #
#   ####
#####
