      ####
#######  #
#        #
#  $ #.# #
#  $## # ##
###   @   #
  ###  #  #
    ##.  ##
     #####
