 ####
 #  ####
 #     #
 # #.  #
##*##$##
#      #
# # @  #
#    ###
######
