    ####
 ####  #
## $   #
#  # #$#
#.@.   ##
## # #  #
 #      #
 #  #####
 ####
