########
#   #  #
#      #
## #.  #
#    ###
# # . #
# $$# #
###  @#
  #####
