 #######
##  #  #
#  **$.##
#   #   #
### @   #
  ####  #
     ####
