     ####
   ###  #
 ### .. #
 # $$#  #
## # #@##
#       #
#   #   #
######  #
     ####
