  ####
  #  ###
 ## .  #
##@$$$ #
# . . ##
#   ###
#  ##
####
