  ####
###  #
#@*  ##
# **$ #
## .  #
#  # ##
#     #
###   #
  #####
