 #######
## .@  #
# $.$  #
# #*# ##
#  $  #
## . ##
 #   #
 #####
