  ####
  #@ #
###  ##
# $$* #
# #  *###
# . *   #
###  .  #
  #######
