 ####
 #  ####
##*  $ #
#    . #
# *  # #
### **@#
  #  ###
  ####
