 #######
 #  # @#
##$ $$ ##
# $ #   #
# #   # #
#    ## ##
## # ##  #
#  ....  #
#   ###  #
##### ####
