##### ####
#   ###  #
# $ #....##
##$@$   $ #
 #   ##   #
 ##  ######
  ####
