   ####
 ###  ##
##     ##
# ****.@#
#    $  #
##### # #
    #   #
    #####
