  #####
  #   #
 ## #.###
## * $  #
#  $ *# #
# #.# # #
# #   # #
#  ###  #
##  @  ##
 #######
