 #######
##  @  ##
#  ###  #
# # . # #
# #$. $ #
# $   ###
###$. #
  # . #
  #####
