 ####
 #  ####
 #   * ##
## #  $.##
#  #$.#  #
#  $  $@ #
#  #..#  #
##########
