 #####
 #   #
##*# #####
# * $ *  #
#   . @  #
###  #*###
  ##   #
   #####
