  ####
###  ####
# $     #
# . *#  #
###.@#$##
# . *#  #
# $     #
######  #
     ####
