 ####
 #  ######
 #       #
## # #.$ #
#  * ## ##
# ** # @#
###   * #
  ####  #
     ####
