  #######
 ##  #  #
##   $$ #
#  #.#  #
#  ...@##
#  #.#$##
## $  $ #
 ####   #
    #####
