#####
#   ####
#    $ #
## ##* ##
#  #..  #
#    $$ #
#  #@.###
#######
