  ####
  #  #
  #* #
###  ###
# .*   #
# #$ # #
#  @** #
##   ###
 #  ##
 ####
