 ######
 #  @ ##
## #   #
# .*.*.#
#  $ $ #
#####$ #
    #  #
    ####
