 ####
 #  #####
 #      #
 # * *  #
##$# # ##
# . *#* #
#       #
####@ ###
   ####
