    #####
#####   #
#       #
#  ..# ##
##$# *  #
 #@.#*  #
 #$ $  ##
 #  ####
 ####
