  #####
###   #
#   # ##
#  **.@#
## * $*##
 # # #  #
 #      #
 ###  ###
   ####
