 #######
##  #  ##
#  **$. #
#   #   #
##  *  ##
 #  * @#
 #######
