######
#    #
# ##$###
# . * @#
##  * .#
 #  $  #
 # #*###
 #   #
 #####
