   #####
####   #
#      #
#  ##.##
## #@  #
 #..$  #
## #$###
#   $ #
# #   #
#   ###
#####
