    ####
  ###  #
  #    #
###  # #
# *$ **##
# #@.#  #
#  #    #
##    ###
 ######
