   #####
 ###   #
##   #@##
# . *$. #
# # $   #
# #$#$###
#  .. #
#######
